1111111111111111111111111111111111
1E0CH000000H000000C000000000000001
1010010100110000101001000000010101
1P10010010101010001001000000010101
10000C00000000C0000000000C000000C1
1111111111111111111111111111111111