1111111111111111111
10C000000E000P00001
1000000000H00000001
1111111111111111111
